10
..........
..i...+...
......+...
..+++.....
..........
++++...+..
.......+..
....++++..
......g...
..........
