10
..........
.I....+...
......+...
..+++.....
..........
++++...+..
.......+..
....++++..
......G...
..........
