10
........+.
...+....+.
...g......
.+++.+....
.+.+......
..........
..+....+..
..........
.i.+......
..........
