11
+++++++++++
i.....+...+
+++++.+.+.+
+.....+.+.+
+.+++++++.+
+.+.......+
+.+.+.+++.+
+...+.+...+
+++++.+.+++
+.....+...g
+++++++++++
